Music Credits:
Song1: perfect for stealth sniper missions music by DesiFreeMusic
Song2: perfect for stealth sniper missions music by DesiFreeMusic
BossSong: Spy Thriller Mission (Covert Ops Music) by DesiFreeMusic
BarSong: Bar Noir by 99qtz

Sound Effect Credits:
ChihuahuaBark: Chihuahua Barking by freesound_community
ChihuahuaDeath: Chihuahua Whines by freesound_community
HuskyBark: 071078_Husky dog barking and "talking" by Freesound Community
HuskyDeath: DOG YELP by Stu9
TanukiBark: Monkey by MagiaZ
TabukiDeath: Puppy crying by belen_abo (Freesound)
PaulBark1: Bark (Wave Leighlah) (F) (Female Furry Funny) by BalancedEnergy10 (Freesound)
PaulBark2-9: Angry Pitbull Dog Barking - Aggressive Guard Dog Sound Effect by MrVailen
PaulAttack1: Cartoon Slap 1 by floraphonic
PaulAttack2: Thud by Universfield
PaulNotice: Spotted Owl2 no noise by Ittldude9 (Freesound)
PaulHasArrived: Suddenly And Without Warning by Universfield
PaulHasArrivedDunDun: Video Game Whoosh Sound Effect by DRAGON-STUDIO
PaulKnockOut: Body Hitting Ground by Universfield
PaulUnconcious: Cartoon dizzy birds - Meme Sound Effect Button for Soundboard by zaakkii05
FireBall1: fire magic (6) by yodguard
FireBall2: fire magic (2) by yodguard
FireBall3: fire magic (1) by yodguard
FireBall4: fire magic (5) by yodguard
FireExplosion: Fire Ball by freesound_CrunchpixStudio
BattleCry: Epic Dragon Roar by DRAGON-STUDIO
BossGrowl: troll roars by Darycho (Freesound)
BossDeath: Ultra Kill by SoundReality
BossHowl: howling by PhonosUPF (Freesound)
BiteAttack: Dog eating a bone and growling by freesound_community
Knife1: Knife Swish 2 by potentjello
Knife2: Knife slice by NeoSpica (Freesound)
Knife3: knife_swish01 by konpeito_sound
PistolLoud: pistol shot by mrfriends
ShotgunAndReload (fire): 080902_Shotgun by Freesound Community and 
ShotgunAndReload (reload): Doom Shotgun 2017 by morganpurkis (Freesound)
PlayerDeathWhine: Animal Dying Sound by ZpPizza
PlayerDeathRetro: Retro Video Game Death by SRJA_Gaming (Freesound)
PlayerGameOver: 080205_Life Lost Game Over by Freesound Community
PlayerGameOverSad: Game Over by Alphix
Crouch: Sneaky Walking by jimmybombimmy (Freesound)
Dash: Quick Whoosh by DRAGON-STUDIO
Drinking: Dog Drinking Water 3 by SOUND_GARAGE
MenuButtonClick: menu click by Lesaek_Szary (Freesound)
MenuPlayAndQuit: menu button by Lesaek_Szary (Freesound)
GlobalSuspicionToHigh: ALERT by freesound_community
DogHurt: Injured Street Dog Crying with Barking Dogs Reacting by arunangshubanerjee
RetroHurt: hit sound(video game type) by RibhavAgrawal
MetalFootsteps: Metal Footsteps by Phil25 (Freesound)
WoodFootstep: Footsteps on Wood by DRAGON-STUDIO
DoorOpen: Spaceship Door Open by MarcusGraham325 (Freesound)
